111111111111111111111111111
1P000000C00000C00C00C000011
100010001110001110011110011
100110000010000010000010011
100010000100000100000100011
100010000010000010001000011
100111001110001110010000011
11000E000000000000000001111
111111111111111111111111111